**********
*    5   *
*        *
*    ^   *
**********